Date,Contest number,Word,Number of  reported results,Number in hard mode,1 try,2 tries,3 tries,4 tries,5 tries,6 tries,7 or more tries (X),under_2,under_3,under_4,under_5,under_6,Overall,D,Hard_rate,pos_0,pos_1,pos_2,pos_3,pos_4,Mul,VN,VP,FS,FF,FB,FE
1/7/2022,202,slump,80630,1362,1,3,23,39,24,9,1,4,27,66,90,99,100,4.130000000000001,0.0168919756914299,s,l,u,m,p,1,1,4,0.4820788331866359,0.15809935205183584,0.03952483801295896,1.2693933421607654e-05
1/8/2022,203,crank,101503,1763,1,5,23,31,24,14,2,6,29,60,84,98,100,4.22,0.0173689447602533,c,r,a,n,k,1,1,4,0.5244975316115651,0.08552915766738661,0.021382289416846653,3.1569567789511536e-05
1/9/2022,204,gorge,91477,1913,1,3,13,27,30,22,4,4,17,44,74,96,100,4.64,0.0209123604840561,g,o,r,g,e,4,2,9,0.5852852149420239,0.04967602591792657,0.012419006479481642,2.8175346033624227e-05
1/10/2022,205,query,107134,2242,1,4,16,30,30,17,2,5,21,51,81,98,100,4.43,0.0209270633038997,q,u,e,r,y,1,2,12,0.49767008208640484,0.009935205183585313,0.002483801295896328,0.00045196257747628465
1/11/2022,206,drink,153880,3017,1,9,35,34,16,5,1,10,45,79,95,100,101,3.77,0.0196061866389394,d,r,i,n,k,1,1,4,0.4640948921515199,0.04794816414686825,0.011987041036717062,0.00042264430516426323
1/12/2022,207,favor,137586,3073,1,4,15,26,29,21,4,5,20,46,75,96,100,4.57,0.0223351213059468,f,a,v,o,r,1,2,10,0.5115777236835786,0.05874730021598272,0.01468682505399568,0.000171453706531761
1/13/2022,208,abbey,132726,3345,1,2,13,29,31,20,3,3,16,45,76,96,99,4.56,0.025202296460377,a,b,b,e,y,4,2,18,0.553766629625809,0.06090712742980561,0.015226781857451403,6.103635463968047e-05
1/14/2022,209,tangy,169484,3985,1,4,21,30,24,15,5,5,26,56,80,95,100,4.369999999999999,0.0235125439569516,t,a,n,g,y,1,1,8,0.5035907446631069,0.06436285097192225,0.016090712742980563,4.820048003740171e-06
1/15/2022,210,panic,205880,4655,1,9,35,34,16,5,1,10,45,79,95,100,101,3.77,0.0226102584029531,p,a,n,i,c,1,2,10,0.5218542857380268,0.061339092872570194,0.015334773218142549,9.2408981749812e-05
1/16/2022,211,solar,209609,4955,1,9,32,32,18,7,1,10,42,74,92,99,100,3.82,0.0236392521313493,s,o,l,a,r,1,2,10,0.7339381065710671,0.15809935205183584,0.03952483801295896,0.00029506128755838504
1/17/2022,212,shire,222197,5640,1,8,32,32,18,8,2,9,41,73,91,99,101,3.93,0.0253828809569886,s,h,i,r,e,1,2,5,0.6928205414018225,0.15809935205183584,0.03952483801295896,3.850226399227863e-05
1/18/2022,213,proxy,220950,6206,1,2,11,24,31,26,6,3,14,38,69,95,101,4.869999999999999,0.0280878026702873,p,r,o,x,y,1,1,4,0.41138739055703355,0.061339092872570194,0.015334773218142549,0.00015563750054357423
1/19/2022,214,point,243964,7094,1,16,37,28,12,4,1,17,54,82,94,98,99,3.47,0.0252795575542901,p,o,i,n,t,1,2,12,0.5183315927575565,0.061339092872570194,0.015334773218142549,0.002535840361031226
1/20/2022,215,robot,243964,6589,1,8,29,34,20,8,1,9,38,72,92,100,101,3.95,0.0270080831598104,r,o,b,o,t,4,2,10,0.5680587070909902,0.04535637149028078,0.011339092872570195,0.00018284497386482584
1/21/2022,216,prick,241489,7409,1,8,30,33,19,7,1,9,39,72,91,98,99,3.83,0.0270671143146273,p,r,i,c,k,1,1,4,0.43022366179177096,0.061339092872570194,0.015334773218142549,1.2877091720696541e-05
1/22/2022,217,wince,241489,6850,1,3,17,33,29,15,3,4,21,54,83,98,101,4.46,0.0283656812525622,w,i,n,c,e,1,2,9,0.521619386035117,0.035853131749460046,0.008963282937365011,1.0359596935822651e-05
1/23/2022,218,crimp,258038,7630,1,5,28,38,20,7,1,6,34,72,92,99,100,3.96,0.0282666923524334,c,r,i,m,p,1,1,4,0.44623128695261294,0.08552915766738661,0.021382289416846653,9.256818702319577e-06
1/24/2022,219,knoll,276404,8317,1,1,11,29,33,21,4,2,13,42,75,96,100,4.71,0.0322316868058192,k,n,o,l,l,4,1,4,0.4947825408461083,0.008639308855291577,0.0021598272138228943,1.3954371105967093e-05
1/25/2022,220,sugar,302348,8708,1,6,25,34,23,9,1,7,32,66,89,98,99,4.000000000000001,0.0315046091952359,s,u,g,a,r,1,2,10,0.6183633345365025,0.15809935205183584,0.03952483801295896,0.0003243386027968999
1/26/2022,221,whack,331844,10163,1,4,22,37,24,10,2,5,27,64,88,98,100,4.17,0.0336135843465146,w,h,a,c,k,1,1,4,0.3834057497976872,0.035853131749460046,0.008963282937365011,1.0486903366771639e-05
1/27/2022,222,mount,296968,11451,1,9,29,33,19,7,1,10,39,72,91,98,99,3.82,0.034507178071624,m,o,u,n,t,1,2,12,0.47685873530230183,0.04622030237580994,0.011555075593952484,0.000529455195312137
1/28/2022,223,perky,313220,11148,1,4,17,30,27,17,4,5,22,52,79,96,100,4.45,0.0375393981843161,p,e,r,k,y,1,1,8,0.5200568684917142,0.061339092872570194,0.015334773218142549,1.9647967754028813e-05
1/29/2022,224,could,294687,11592,1,7,29,35,20,8,1,8,37,72,92,100,101,3.97,0.0370091309622629,c,o,u,l,d,1,2,12,0.4677997669729445,0.08552915766738661,0.021382289416846653,0.0043674749563880145
1/30/2022,225,wrung,341314,11524,0,2,18,39,27,12,2,2,20,59,86,98,100,4.35,0.0391058988011008,w,r,u,n,g,1,1,4,0.39639028160847445,0.035853131749460046,0.008963282937365011,1.7503767439115307e-06
1/31/2022,226,light,351663,13606,1,10,25,27,19,12,5,11,36,63,82,94,99,4.06,0.0391047539802059,l,i,g,h,t,1,1,8,0.4501668703136948,0.03801295896328294,0.009503239740820735,0.001830421919254444
2/1/2022,227,those,361908,14205,1,13,34,30,15,6,1,14,48,78,93,99,100,3.67,0.0386904508009088,t,h,o,s,e,1,2,5,0.6834839429604569,0.06436285097192225,0.016090712742980563,0.0039008779614692177
2/2/2022,228,moist,358176,14609,3,13,32,29,16,7,1,16,48,77,93,100,101,3.7,0.039250306707782,m,o,i,s,t,1,2,12,0.5901144321328461,0.04622030237580994,0.011555075593952484,3.092390516899722e-05
2/3/2022,229,shard,359679,14813,1,7,22,28,25,14,4,8,30,58,83,97,101,4.300000000000001,0.0407872107567229,s,h,a,r,d,1,1,4,0.6197223253011486,0.15809935205183584,0.03952483801295896,4.152454929051936e-06
2/4/2022,230,pleat,319698,13708,1,10,28,31,19,9,2,11,39,70,89,98,100,3.92,0.0411839445727996,p,l,e,a,t,1,2,6,0.6727618691696369,0.061339092872570194,0.015334773218142549,3.854876869055653e-06
2/5/2022,231,aloft,311018,13716,1,4,22,36,25,11,2,5,27,63,88,99,101,4.239999999999999,0.0428779660804884,a,l,o,f,t,1,2,20,0.572401003528238,0.06090712742980561,0.015226781857451403,7.1850697890412476e-06
2/6/2022,232,skill,288228,13340,1,3,17,33,27,16,3,4,21,54,81,97,100,4.42,0.0441003414593367,s,k,i,l,l,4,1,4,0.5524655287969193,0.15809935205183584,0.03952483801295896,0.00022876838508465428
2/7/2022,233,elder,336236,15369,1,3,13,24,30,24,5,4,17,41,71,95,100,4.709999999999999,0.0462828038913637,e,l,d,e,r,4,2,18,0.7401458435638182,0.031101511879049675,0.007775377969762419,0.00010545500153418154
2/8/2022,234,frame,305372,13846,1,10,20,24,24,17,3,11,31,55,79,96,99,4.2,0.0457089663212743,f,r,a,m,e,1,2,5,0.6207907963027779,0.05874730021598272,0.01468682505399568,0.000665714842529673
2/9/2022,235,humor,304830,13480,1,5,22,34,25,11,2,6,28,62,87,98,100,4.18,0.045341419645547,h,u,m,o,r,1,2,10,0.4696023725064554,0.029805615550755938,0.0074514038876889845,0.00026128005224645523
2/10/2022,236,pause,278826,10631,1,8,26,32,21,10,2,9,35,67,88,98,100,4.0200000000000005,0.0442213692877997,p,a,u,s,e,1,3,13,0.6987677209901278,0.061339092872570194,0.015334773218142549,6.654719750295954e-05
2/11/2022,237,ulcer,269885,10631,1,4,18,30,28,16,3,5,23,53,81,97,100,4.4,0.038127721231162,u,l,c,e,r,1,2,18,0.608147029573845,0.014254859611231102,0.0035637149028077755,1.9309851581771653e-05
2/12/2022,238,ultra,261521,9310,1,7,23,34,24,10,1,8,31,65,89,99,100,4.07,0.0344961742964596,u,l,t,r,a,1,2,17,0.6191781469343202,0.014254859611231102,0.0035637149028077755,0.00031487213010843277
2/14/2022,240,cynic,287836,10343,1,6,25,33,22,11,2,7,32,65,87,98,100,4.1,0.039549405210289,c,y,n,i,c,4,1,2,0.4185056070995225,0.08552915766738661,0.021382289416846653,7.59773216916232e-06
2/15/2022,241,aroma,289721,10343,1,6,25,33,22,11,2,7,32,65,87,98,100,4.1,0.0359336566656012,a,r,o,m,a,4,3,21,0.6888011753091844,0.06090712742980561,0.015226781857451403,2.9165149200170755e-05
2/16/2022,242,caulk,342003,10740,1,4,20,31,26,15,3,5,25,56,82,97,100,4.34,0.0370701467964006,c,a,u,l,k,1,2,12,0.4819753349637256,0.08552915766738661,0.021382289416846653,3.553138090480918e-06
2/17/2022,243,shake,265238,12767,1,6,16,23,24,21,9,7,23,46,70,91,100,4.62,0.0373300818998663,s,h,a,k,e,1,2,5,0.6591353273515355,0.15809935205183584,0.03952483801295896,9.880722787240128e-05
2/18/2022,244,dodge,282327,10220,1,3,15,29,27,19,7,4,19,48,75,94,101,4.66,0.0385314321477314,d,o,d,g,e,4,2,9,0.5397965178080866,0.04794816414686825,0.011987041036717062,0.00021335975615388158
2/19/2022,245,swill,273306,11241,1,1,8,19,31,30,10,2,10,29,60,90,100,5.08,0.0398155330520991,s,w,i,l,l,4,1,4,0.5427057120407377,0.15809935205183584,0.03952483801295896,1.3295807368471678e-06
2/20/2022,246,tacit,278731,11094,1,4,21,32,26,14,3,5,26,58,84,98,101,4.35,0.0405918640644552,t,a,c,i,t,4,2,10,0.5871331288148351,0.06436285097192225,0.016090712742980563,8.585166037629451e-06
2/21/2022,247,other,306356,10887,1,9,26,30,21,10,2,10,36,66,87,97,99,3.96,0.0390591645708586,o,t,h,e,r,1,2,18,0.6519890535246811,0.017710583153347732,0.004427645788336933,0.014136060425799816
2/22/2022,248,thorn,277576,11814,1,14,38,30,12,4,0,15,53,83,95,99,99,3.47,0.0385629790178746,t,h,o,r,n,1,1,4,0.5378654940597152,0.06436285097192225,0.016090712742980563,2.0538823831881558e-05
2/23/2022,249,trove,250674,11411,1,5,16,24,25,22,8,6,22,46,71,93,101,4.68,0.0411094619131337,t,r,o,v,e,1,2,5,0.6160236683176634,0.06436285097192225,0.016090712742980563,1.0146851304620336e-05
2/24/2022,250,bloke,250674,10405,1,6,21,32,25,12,2,7,28,60,85,97,99,4.15,0.0415080941780958,b,l,o,k,e,1,2,5,0.5465562155984638,0.07473002159827213,0.018682505399568033,1.1077378678363449e-05
2/25/2022,251,vivid,248363,11687,1,2,10,29,33,21,4,3,13,42,75,96,100,4.7,0.0456689344175813,v,i,v,i,d,16,2,10,0.3511992705592467,0.018574514038876888,0.004643628509719222,6.471526778552247e-05
2/26/2022,252,spill,248363,10087,1,5,26,34,22,10,2,6,32,66,88,98,100,4.09,0.0406139400796414,s,p,i,l,l,4,1,4,0.5727290654131548,0.15809935205183584,0.03952483801295896,5.620792741102536e-05
2/27/2022,253,chant,250413,10438,1,9,33,33,16,7,1,10,43,76,92,99,100,3.79,0.0416831394536226,c,h,a,n,t,1,1,4,0.5136958257189477,0.08552915766738661,0.021382289416846653,1.9856278174802015e-05
2/28/2022,254,choke,240137,10521,1,8,30,36,18,6,1,9,39,75,93,99,100,3.84,0.0419006427871633,c,h,o,k,e,1,2,5,0.5147862415540866,0.08552915766738661,0.021382289416846653,2.0921277661490336e-05
3/1/2022,255,rupee,240137,10577,1,2,17,35,30,13,2,3,20,55,85,98,100,4.38,0.0440456905849577,r,u,p,e,e,4,3,11,0.6970612852238594,0.04535637149028078,0.011339092872570195,4.0907029308167614e-05
3/2/2022,256,nasty,240018,10813,1,7,26,31,21,11,2,8,34,65,86,97,99,4.02,0.0420242203774523,n,a,s,t,y,1,1,8,0.6220300268068261,0.015982721382289417,0.003995680345572354,0.00010741078486402507
3/3/2022,257,mourn,240018,10465,1,8,29,34,19,8,1,9,38,72,91,99,100,3.9,0.0436008965994217,m,o,u,r,n,1,2,12,0.5045510966235397,0.04622030237580994,0.011555075593952484,1.1254310346524168e-05
3/4/2022,258,ahead,203730,9396,1,5,20,35,26,12,2,6,26,61,87,99,101,4.27,0.0461198645265793,a,h,e,a,d,4,3,22,0.6975983783359825,0.06090712742980561,0.015226781857451403,0.00040993651712766693
3/5/2022,259,brine,229895,10405,1,9,25,29,22,12,3,10,35,64,86,98,101,4.13,0.0452597925139737,b,r,i,n,e,1,2,5,0.6069821618174083,0.07473002159827213,0.018682505399568033,1.1788745979762469e-05
3/6/2022,260,cloth,218595,9911,1,8,33,34,17,7,1,9,42,76,93,100,101,3.86,0.0453395548846039,c,l,o,t,h,1,1,4,0.4869550935502902,0.08552915766738661,0.021382289416846653,0.0001410618965918017
3/7/2022,261,hoard,218595,9823,1,9,30,34,19,7,1,10,40,74,93,100,101,3.89,0.0449369839200347,h,o,a,r,d,1,2,12,0.5836764162554713,0.029805615550755938,0.0074514038876889845,6.2609424095004055e-06
3/8/2022,262,sweet,207473,9767,1,5,18,31,28,15,2,6,24,55,83,98,100,4.329999999999999,0.0470760050705393,s,w,e,e,t,4,2,6,0.7309641884556151,0.15809935205183584,0.03952483801295896,0.00046680839698462435
3/9/2022,263,month,201799,9435,1,5,26,37,22,8,1,6,32,69,91,99,100,4.0200000000000005,0.0467544437782149,m,o,n,t,h,1,1,8,0.45748987827994503,0.04622030237580994,0.011555075593952484,0.0017773775393161737
3/10/2022,264,lapse,208884,9960,0,8,31,34,19,7,1,8,39,73,92,99,100,3.89,0.0476819670247601,l,a,p,s,e,1,2,9,0.7319491199266506,0.03801295896328294,0.009503239740820735,2.1085914984129315e-05
3/11/2022,265,watch,226349,12400,1,6,14,18,17,24,20,7,21,39,56,80,100,4.96,0.0547826586377673,w,a,t,c,h,1,1,8,0.4520966294170615,0.035853131749460046,0.008963282937365011,0.0013292191299512698
3/12/2022,266,today,192049,9353,1,7,29,35,20,7,1,8,37,72,92,99,100,3.91,0.0487011127368536,t,o,d,a,y,1,2,10,0.5643114342351158,0.06436285097192225,0.016090712742980563,0.003456736610316292
3/13/2022,267,focus,179436,8937,1,4,23,36,24,10,1,5,28,64,88,98,99,4.09,0.0498060589848191,f,o,c,u,s,1,2,10,0.49010367859695747,0.05874730021598272,0.01468682505399568,0.00094810542734518
3/14/2022,268,smelt,185406,9373,0,5,19,33,28,13,2,5,24,57,85,98,100,4.31,0.0505539195063805,s,m,e,l,t,1,1,4,0.6602096027494679,0.15809935205183584,0.03952483801295896,4.3492944798553805e-06
3/15/2022,269,tease,202855,10024,1,16,32,30,16,6,1,17,49,79,95,101,102,3.72,0.0494146064923221,t,e,a,s,e,4,3,13,0.87689849055296,0.06436285097192225,0.016090712742980563,2.9172343776045992e-05
3/16/2022,270,cater,217856,11234,1,7,19,22,19,18,15,8,27,49,68,86,101,4.680000000000001,0.0515661721504112,c,a,t,e,r,1,2,10,0.7073119706959055,0.08552915766738661,0.021382289416846653,3.023495951771541e-05
3/17/2022,271,movie,169071,8847,1,5,18,30,26,16,3,6,24,54,80,96,99,4.32,0.0523271288393633,m,o,v,i,e,1,3,11,0.5404336313693572,0.04622030237580994,0.011555075593952484,0.0022887000485715715
3/18/2022,272,saute,179830,9304,1,8,31,34,19,6,1,9,40,74,93,99,100,3.84,0.0517377523216371,s,a,u,t,e,1,3,13,0.7471950639932665,0.15809935205183584,0.03952483801295896,7.894631223001703e-06
3/19/2022,273,allow,156311,8515,0,5,21,32,26,14,3,5,26,58,84,98,101,4.359999999999999,0.0544747330642117,a,l,l,o,w,4,2,18,0.5693578298853854,0.06090712742980561,0.015226781857451403,0.000968704379339296
3/20/2022,274,renew,154987,8417,0,4,20,33,27,13,2,4,24,57,84,97,99,4.27,0.0543077806525708,r,e,n,e,w,4,2,10,0.6826177989461697,0.04535637149028078,0.011339092872570195,9.478754031743255e-05
3/21/2022,275,their,173636,9200,2,14,36,30,13,4,0,16,52,82,95,99,99,3.47,0.0529844041558202,t,h,e,i,r,1,2,6,0.6336332906448088,0.06436285097192225,0.016090712742980563,0.011309778084989475
3/22/2022,276,slosh,160161,8807,0,2,19,36,27,13,2,2,21,57,84,97,99,4.319999999999999,0.0549884179044836,s,l,o,s,h,4,1,4,0.6461491660943,0.15809935205183584,0.03952483801295896,7.459532745823915e-07
3/23/2022,277,purge,156785,8555,1,4,22,35,26,11,2,5,27,62,88,99,101,4.25,0.0545651688618171,p,u,r,g,e,1,2,9,0.5405371944458575,0.061339092872570194,0.015334773218142549,1.9736469705457945e-05
3/24/2022,278,chest,169066,9318,1,14,35,31,14,5,1,15,50,81,95,100,101,3.65,0.0551145706410514,c,h,e,s,t,1,1,4,0.6195230302191382,0.08552915766738661,0.021382289416846653,0.00019527081542997408
3/25/2022,279,depot,150197,8562,0,5,29,36,20,7,1,5,34,70,90,97,98,3.9,0.0570051332583207,d,e,p,o,t,1,2,10,0.5891453897913559,0.04794816414686825,0.011987041036717062,0.00013996683302399619
3/26/2022,280,epoxy,149507,9376,0,2,13,31,33,18,3,2,15,46,79,97,100,4.61,0.0627127826790718,e,p,o,x,y,1,2,20,0.48096708862709203,0.031101511879049675,0.007775377969762419,2.7565858549639217e-05
3/28/2022,282,found,173696,10613,1,6,17,22,20,21,14,7,24,46,66,87,101,4.760000000000001,0.0611010040530582,f,o,u,n,d,1,2,12,0.41636031519655403,0.05874730021598272,0.01468682505399568,0.0033517751162357215
3/29/2022,283,shall,149070,8494,0,3,17,30,28,17,4,3,20,50,78,95,99,4.47,0.0569799423089823,s,h,a,l,l,4,1,4,0.6320542111158648,0.15809935205183584,0.03952483801295896,0.002773290374368608
3/30/2022,284,stove,158139,9318,0,5,16,24,27,21,6,5,21,45,72,93,99,4.57,0.0589228463566862,s,t,o,v,e,1,2,5,0.6475185577534393,0.15809935205183584,0.03952483801295896,5.655758668794982e-05
3/31/2022,285,lowly,135219,8469,0,2,9,26,32,24,8,2,11,37,69,93,101,4.950000000000001,0.0626317307478978,l,o,w,l,y,4,1,8,0.45840137927372493,0.03801295896328294,0.009503239740820735,7.85170936572192e-06
4/1/2022,286,snout,144648,8913,1,4,19,27,26,18,5,5,24,51,77,95,100,4.47,0.0616185498589679,s,n,o,u,t,1,2,6,0.5887292405178478,0.15809935205183584,0.03952483801295896,3.731846732201183e-06
4/2/2022,287,trope,155079,9315,1,16,33,28,15,6,1,17,50,78,93,99,100,3.62,0.0600661598282165,t,r,o,p,e,1,2,5,0.6553619347122963,0.06436285097192225,0.016090712742980563,1.5807696740816265e-06
4/3/2022,288,fewer,124532,7931,0,2,10,24,32,26,6,2,12,36,68,94,100,4.88,0.063686442038994,f,e,w,e,r,4,2,10,0.6248118080552617,0.05874730021598272,0.01468682505399568,0.00015592272647029073
4/4/2022,289,shawl,129651,7943,0,3,16,31,30,16,3,3,19,50,80,96,99,4.45,0.0612644715428342,s,h,a,w,l,1,1,4,0.5528534829721833,0.15809935205183584,0.03952483801295896,1.4616373215065535e-05
4/5/2022,290,natal,121356,7702,0,2,14,32,32,17,3,2,16,48,80,97,100,4.569999999999999,0.0634661656613599,n,a,t,a,l,4,2,10,0.6745492584295987,0.015982721382289417,0.003995680345572354,4.348569243492053e-05
4/6/2022,291,comma,117856,7560,0,2,13,33,33,17,3,2,15,48,81,98,101,4.63,0.0641460765680152,c,o,m,m,a,4,2,9,0.5001223827776428,0.08552915766738661,0.021382289416846653,3.9173194309993327e-05
4/7/2022,292,foray,117761,7575,0,2,14,31,31,19,4,2,16,47,78,97,101,4.67,0.06432520104279,f,o,r,a,y,1,2,10,0.5558704881914787,0.05874730021598272,0.01468682505399568,7.2206959418692326e-06
4/8/2022,293,scare,141158,9010,1,12,23,26,21,13,4,13,36,62,83,96,100,4.090000000000001,0.0638291843182816,s,c,a,r,e,1,2,5,0.7664992214529189,0.15809935205183584,0.03952483801295896,4.2946532652462954e-05
4/9/2022,294,stair,134210,8537,2,21,36,26,11,4,1,23,59,85,96,100,101,3.4200000000000004,0.063609269055957,s,t,a,i,r,1,2,6,0.7148323119230691,0.15809935205183584,0.03952483801295896,2.9074812487424043e-05
4/10/2022,295,black,126241,7894,1,10,31,34,18,6,1,11,42,76,94,100,101,3.83,0.0625311903422818,b,l,a,c,k,1,1,4,0.45280684918763786,0.07473002159827213,0.018682505399568033,0.0035350238676128704
4/11/2022,296,squad,109828,7236,0,3,20,33,27,14,2,3,23,56,83,97,99,4.31,0.0658848381105,s,q,u,a,d,1,2,6,0.5043251791428423,0.15809935205183584,0.03952483801295896,0.0001263351920997097
4/12/2022,297,royal,114907,7275,1,5,24,36,23,9,1,6,30,66,89,98,99,4.03,0.063312069760763,r,o,y,a,l,1,2,10,0.6312780109241819,0.04535637149028078,0.011339092872570195,0.0006559949127344685
4/13/2022,298,chunk,123255,7835,1,4,29,42,18,5,1,5,34,76,94,99,100,3.9099999999999993,0.0635674009167985,c,h,u,n,k,1,1,4,0.3450899732093873,0.08552915766738661,0.021382289416846653,3.4257030817703045e-05
4/14/2022,299,mince,113448,7356,0,6,24,35,24,10,1,6,30,65,89,99,100,4.11,0.0648402792468796,m,i,n,c,e,1,2,9,0.5473868279521404,0.04622030237580994,0.011555075593952484,4.739159589432024e-06
4/15/2022,300,shame,129991,8522,1,11,22,25,21,15,5,12,34,59,80,95,100,4.19,0.0655583848112561,s,h,a,m,e,1,2,5,0.6751429525123773,0.15809935205183584,0.03952483801295896,9.802676085933306e-05
4/16/2022,301,cheek,107987,7035,0,3,19,40,28,9,1,3,22,62,90,99,100,4.24,0.0651467306249826,c,h,e,e,k,4,2,6,0.5889169592340466,0.08552915766738661,0.021382289416846653,3.8732663783560345e-05
4/17/2022,302,ample,106681,7008,0,4,20,35,27,11,2,4,24,59,86,97,99,4.23,0.0656911727486619,a,m,p,l,e,1,2,17,0.6200786147111046,0.06090712742980561,0.015226781857451403,4.6054560536686684e-05
4/18/2022,303,flair,112383,7341,1,8,30,36,18,6,1,9,39,75,93,99,100,3.84,0.0653212674514828,f,l,a,i,r,1,2,6,0.5817376019696036,0.05874730021598272,0.01468682505399568,2.7798656532879345e-05
4/19/2022,304,foyer,108899,8198,0,2,10,19,19,23,26,2,12,31,50,73,99,5.25,0.0752807647453144,f,o,y,e,r,1,2,10,0.5856589418609859,0.05874730021598272,0.01468682505399568,1.506139673968567e-05
4/20/2022,305,cargo,102007,6796,0,5,20,34,27,12,2,5,25,59,86,98,100,4.27,0.0666228788220416,c,a,r,g,o,1,2,9,0.5739292216292398,0.08552915766738661,0.021382289416846653,0.00014083841688454455
4/21/2022,306,oxide,97955,6960,0,2,11,30,33,21,4,2,13,43,76,97,101,4.76,0.0710530345566841,o,x,i,d,e,1,3,21,0.5391286717518637,0.017710583153347732,0.004427645788336933,7.687707708421319e-05
4/22/2022,307,plant,119232,7731,2,19,39,28,10,3,0,21,60,88,98,101,101,3.37,0.0648399758454106,p,l,a,n,t,1,1,4,0.558638309704671,0.061339092872570194,0.015334773218142549,0.0007692649573018994
4/23/2022,308,olive,95562,6482,1,6,25,34,23,10,1,7,32,66,89,99,100,4.0600000000000005,0.0678303091186873,o,l,i,v,e,1,3,21,0.5938669175960152,0.017710583153347732,0.004427645788336933,0.00013433030178699307
4/24/2022,309,inert,97452,6743,0,7,27,34,22,9,1,7,34,68,90,99,100,4.0200000000000005,0.0691930386241431,i,n,e,r,t,1,2,20,0.668582014761893,0.01468682505399568,0.00367170626349892,1.3520861792135242e-05
4/25/2022,310,askew,91548,6549,0,3,13,29,32,19,4,3,16,45,77,96,100,4.63,0.0715362432822126,a,s,k,e,w,1,2,18,0.6324848551667335,0.06090712742980561,0.015226781857451403,6.842995155358755e-06
4/26/2022,311,heist,103153,6830,1,13,32,31,16,6,1,14,46,77,93,99,100,3.6999999999999993,0.0662123253807451,h,e,i,s,t,1,2,12,0.6651281800805846,0.029805615550755938,0.0074514038876889845,6.062354779016431e-06
4/27/2022,312,shown,98967,6564,0,6,26,36,22,8,1,6,32,68,90,98,99,3.99,0.0663251386825911,s,h,o,w,n,1,1,4,0.49090968711993516,0.15809935205183584,0.03952483801295896,0.000993310580073464
4/28/2022,313,zesty,88974,6315,0,2,12,27,30,22,7,2,14,41,71,93,100,4.79,0.0709757906804234,z,e,s,t,y,1,1,8,0.5683832020284582,0.0012958963282937365,0.00032397408207343413,3.035648717286099e-06
4/29/2022,314,stash,106652,7001,2,19,34,27,13,4,1,21,55,82,95,99,100,3.4599999999999995,0.065643400967633,s,t,a,s,h,4,1,4,0.6897413983366271,0.15809935205183584,0.03952483801295896,2.2446744451133387e-05
4/30/2022,315,larva,77991,5749,0,2,10,25,35,23,4,2,12,37,72,95,99,4.75,0.0737136336243925,l,a,r,v,a,4,2,9,0.6313275104267346,0.03801295896328294,0.009503239740820735,6.6787912409050326e-06
5/1/2022,316,forgo,77658,5699,0,1,9,26,37,23,3,1,10,36,73,96,99,4.7700000000000005,0.0733858713847897,f,o,r,g,o,4,2,9,0.4957490376841918,0.05874730021598272,0.01468682505399568,4.918113829123935e-06
5/2/2022,317,story,95643,6530,1,10,23,29,24,11,2,11,34,63,87,98,100,4.06,0.0682747299854667,s,t,o,r,y,1,1,4,0.6222316241912808,0.15809935205183584,0.03952483801295896,0.0019999448645555903
5/3/2022,318,hairy,85817,5941,1,8,24,33,23,10,1,9,33,66,89,99,100,4.03,0.0692287075987275,h,a,i,r,y,1,2,12,0.56037199208543,0.029805615550755938,0.0074514038876889845,0.0002753676096877513
5/4/2022,319,train,107750,7243,6,26,32,22,10,3,0,32,64,86,96,99,99,3.1,0.0672204176334106,t,r,a,i,n,1,2,6,0.6387935610923857,0.06436285097192225,0.016090712742980563,0.00045965785538100846
5/5/2022,320,homer,85979,6313,0,3,16,26,24,19,12,3,19,45,69,88,100,4.76,0.0734249060817176,h,o,m,e,r,1,2,10,0.5993057990661488,0.029805615550755938,0.0074514038876889845,6.185353132603981e-05
5/6/2022,321,badge,76292,5482,0,4,20,35,26,12,2,4,24,59,85,97,99,4.239999999999999,0.0718555025428616,b,a,d,g,e,1,2,9,0.5610631124737571,0.07473002159827213,0.018682505399568033,8.87784369574445e-05
5/7/2022,322,midst,74458,5233,0,3,25,39,24,9,1,3,28,67,91,100,101,4.180000000000001,0.0702812323726127,m,i,d,s,t,1,1,8,0.5284489068218072,0.04622030237580994,0.011555075593952484,4.88510257234699e-05
5/8/2022,323,canny,72518,5256,0,2,10,30,34,20,4,2,12,42,76,96,100,4.720000000000001,0.0724785570479053,c,a,n,n,y,4,1,8,0.5051717049461604,0.08552915766738661,0.021382289416846653,3.026344888242619e-06
5/9/2022,324,shine,88932,6146,1,14,32,30,17,6,1,15,47,77,94,100,101,3.73,0.0691089821436603,s,h,i,n,e,1,2,5,0.6482766800069151,0.15809935205183584,0.03952483801295896,8.497490451140207e-05
5/10/2022,325,gecko,74412,5489,0,2,16,38,29,12,2,2,18,56,85,97,99,4.35,0.0737649841423426,g,e,c,k,o,1,2,9,0.507334434358135,0.04967602591792657,0.012419006479481642,1.777278389970327e-05
5/11/2022,326,farce,79446,5688,0,9,26,32,21,9,1,9,35,67,88,97,98,3.9,0.0715958009213805,f,a,r,c,e,1,2,9,0.6326544797313278,0.05874730021598272,0.01468682505399568,1.0510813051658222e-05
5/12/2022,327,slung,75673,5419,0,2,16,37,31,13,2,2,18,55,86,99,101,4.47,0.0716107462370991,s,l,u,n,g,1,1,4,0.5070858991879317,0.15809935205183584,0.03952483801295896,3.6589041346227176e-06
5/13/2022,328,tipsy,77585,5522,0,6,33,38,17,5,1,6,39,77,94,99,100,3.85,0.0711735515885802,t,i,p,s,y,1,1,8,0.5277561569870319,0.06436285097192225,0.016090712742980563,4.037399502806164e-06
5/14/2022,329,metal,73225,5290,1,10,31,34,18,7,1,11,42,76,94,101,102,3.89,0.0722430863776032,m,e,t,a,l,1,2,10,0.6685059577142434,0.04622030237580994,0.011555075593952484,0.0008116548204812205
5/15/2022,330,yield,67115,4963,0,4,16,29,29,18,4,4,20,49,78,96,100,4.53,0.0739477017060269,y,i,e,l,d,1,2,12,0.5764941567928765,0.002591792656587473,0.0006479481641468683,0.00021702906208495042
5/16/2022,331,delve,68349,5179,0,2,14,32,33,16,2,2,16,48,81,97,99,4.489999999999999,0.0757728715855389,d,e,l,v,e,4,2,9,0.6246878728448089,0.04794816414686825,0.011987041036717062,9.259173553459465e-06
5/17/2022,332,being,70722,5142,0,4,22,37,26,10,1,4,26,63,89,99,100,4.19,0.072707219818444,b,e,i,n,g,1,2,12,0.520037769109465,0.07473002159827213,0.018682505399568033,0.003507472629366014
5/18/2022,333,scour,73933,5544,0,8,34,35,17,5,1,8,42,77,94,99,100,3.8,0.0749868123841856,s,c,o,u,r,1,2,6,0.5924535308827729,0.15809935205183584,0.03952483801295896,5.944597775082568e-06
5/19/2022,334,glass,70920,5162,0,4,19,33,27,14,3,4,23,56,83,97,100,4.37,0.0727862380146644,g,l,a,s,s,4,1,4,0.683039622908801,0.04967602591792657,0.012419006479481642,0.0009182439212137596
5/20/2022,335,gamer,69884,5238,1,4,17,28,26,18,6,5,22,50,76,94,100,4.5200000000000005,0.0749527788907332,g,a,m,e,r,1,2,10,0.63619625588065,0.04967602591792657,0.012419006479481642,4.5435408050170484e-05
5/21/2022,336,scrap,66814,4973,1,9,28,34,20,8,1,10,38,72,92,100,101,3.94,0.0744305085760469,s,c,r,a,p,1,1,2,0.620799819058484,0.15809935205183584,0.03952483801295896,5.4278379723329296e-05
5/22/2022,337,money,67909,4928,1,7,26,36,21,8,1,8,34,70,91,99,100,3.97,0.0725677008938432,m,o,n,e,y,1,2,10,0.5630893169721236,0.04622030237580994,0.011555075593952484,0.0027478811693957385
5/23/2022,338,hinge,66431,4906,0,5,25,37,22,9,2,5,30,67,89,98,100,4.11,0.0738510635095061,h,i,n,g,e,1,2,9,0.5298373978631958,0.029805615550755938,0.0074514038876889845,2.5410620772941212e-05
5/24/2022,339,album,63380,4809,0,5,26,35,24,9,1,5,31,66,90,99,100,4.090000000000001,0.0758756705585358,a,l,b,u,m,1,2,18,0.47720267821006523,0.06090712742980561,0.015226781857451403,0.0011256234100989122
5/25/2022,340,vouch,62723,4835,0,2,9,25,33,24,6,2,11,36,69,93,99,4.82,0.0770849608596527,v,o,u,c,h,1,2,12,0.3660080852159959,0.018574514038876888,0.004643628509719222,5.619324932048471e-06
5/26/2022,341,asset,63188,4733,0,7,28,34,21,8,1,7,35,69,90,98,99,3.94,0.0749034626827878,a,s,s,e,t,4,2,18,0.8388136819186773,0.06090712742980561,0.015226781857451403,0.00026262734493113983
5/27/2022,342,tiara,63846,4842,0,8,36,33,17,6,1,8,44,77,94,100,101,3.84,0.0758387369608119,t,i,a,r,a,4,3,13,0.7231286668878444,0.06436285097192225,0.016090712742980563,1.3339364891089834e-05
5/28/2022,343,crept,60069,4562,0,4,27,38,22,7,1,4,31,69,91,98,99,4.0,0.0759459954385789,c,r,e,p,t,1,1,4,0.5914010219709775,0.08552915766738661,0.021382289416846653,8.505418931542477e-06
5/29/2022,344,bayou,56839,4435,0,6,17,33,29,13,2,6,23,56,85,98,100,4.32,0.0780274107566987,b,a,y,o,u,1,3,11,0.5088043977219365,0.07473002159827213,0.018682505399568033,2.019621466143725e-05
5/30/2022,345,atoll,60969,4741,0,6,28,36,21,8,1,6,34,70,91,99,100,4.0,0.0777608292738932,a,t,o,l,l,4,2,20,0.6478085262609412,0.06090712742980561,0.015226781857451403,1.3124625582235347e-05
5/31/2022,346,manor,62768,4802,0,6,27,34,21,10,2,6,33,67,88,98,100,4.08,0.0765039510578638,m,a,n,o,r,1,2,10,0.6044660695137257,0.04622030237580994,0.011555075593952484,0.0001023520589726648
6/1/2022,347,creak,63241,4797,0,5,21,32,25,14,3,5,26,58,83,97,100,4.31,0.0758526905014152,c,r,e,a,k,1,2,6,0.6386210910765311,0.08552915766738661,0.021382289416846653,1.7931830256752451e-06
6/2/2022,348,showy,61278,4770,0,2,16,37,30,13,2,2,18,55,85,98,100,4.42,0.0778419661216097,s,h,o,w,y,1,1,4,0.4642883423037333,0.15809935205183584,0.03952483801295896,4.258928873229653e-06
6/3/2022,349,peach,65431,4957,1,13,38,32,13,3,0,14,52,84,97,100,100,3.52,0.0757591967110391,p,e,a,c,h,1,2,12,0.5793920421807749,0.061339092872570194,0.015334773218142549,5.689303017639791e-05
6/4/2022,350,froth,58263,4432,0,5,22,35,25,11,1,5,27,62,87,98,99,4.140000000000001,0.076068860168546,f,r,o,t,h,1,1,4,0.4800595031688072,0.05874730021598272,0.01468682505399568,4.023024797995197e-06
6/5/2022,351,depth,56738,4329,0,6,28,39,20,6,1,6,34,73,93,99,100,3.95,0.0762980718389791,d,e,p,t,h,1,1,8,0.5142038238892658,0.04794816414686825,0.011987041036717062,0.00046056736245776665
6/6/2022,352,gloom,58478,4548,0,2,14,35,35,13,1,2,16,51,86,99,100,4.460000000000001,0.0777728376483463,g,l,o,o,m,4,2,6,0.4907809446371249,0.04967602591792657,0.012419006479481642,1.2684672933382699e-05
6/7/2022,353,flood,58991,4440,0,3,20,40,28,8,1,3,23,63,91,99,100,4.210000000000001,0.0752657184994321,f,l,o,o,d,4,2,6,0.4895345559180826,0.05874730021598272,0.01468682505399568,0.00020195762472230633
6/8/2022,354,trait,61026,4607,0,6,22,35,24,11,2,6,28,63,87,98,100,4.18,0.075492413069839,t,r,a,i,t,4,2,6,0.6556450611660554,0.06436285097192225,0.016090712742980563,2.4638056235784144e-05
6/9/2022,355,girth,60020,4665,0,6,23,33,23,12,3,6,29,62,85,97,100,4.21,0.0777240919693435,g,i,r,t,h,1,1,8,0.4771091998668069,0.04967602591792657,0.012419006479481642,7.121170975595109e-06
6/10/2022,356,piety,55376,4324,0,4,25,41,22,7,1,4,29,70,92,99,100,4.0600000000000005,0.0780843686795723,p,i,e,t,y,1,2,12,0.5658409656213146,0.061339092872570194,0.015334773218142549,8.601548867032102e-06
6/11/2022,357,goose,51958,4087,0,2,12,28,32,21,5,2,14,42,74,95,100,4.73,0.0786596866700027,g,o,o,s,e,4,3,13,0.6991734774758416,0.04967602591792657,0.012419006479481642,5.402262555321014e-05
6/12/2022,358,float,56684,4323,1,12,30,32,18,6,1,13,43,75,93,99,100,3.7599999999999993,0.0762649072048549,f,l,o,a,t,1,2,6,0.572401003528238,0.05874730021598272,0.01468682505399568,0.0001272581059363318
6/13/2022,359,donor,53802,4142,0,3,27,38,23,7,1,3,30,68,91,98,99,4.03,0.076985985651091,d,o,n,o,r,4,2,10,0.5742828763621027,0.04794816414686825,0.011987041036717062,0.00010252523443655331
6/14/2022,360,atone,59968,4762,2,16,34,29,14,4,1,18,52,81,95,99,100,3.53,0.0794090181430096,a,t,o,n,e,1,3,21,0.7267290220423166,0.06090712742980561,0.015226781857451403,2.208951497790647e-06
6/15/2022,361,primo,55989,4391,0,3,22,38,25,10,2,3,25,63,88,98,100,4.23,0.0784261194163139,p,r,i,m,o,1,2,5,0.5101921996939316,0.061339092872570194,0.015334773218142549,1.3177342464501897e-05
6/16/2022,362,apron,53430,4112,0,7,30,38,19,5,1,7,37,75,94,99,100,3.88,0.0769605090772974,a,p,r,o,n,1,2,18,0.6087219809691193,0.06090712742980561,0.015226781857451403,2.3365858742664778e-05
6/17/2022,363,blown,54665,4251,0,6,23,35,26,10,1,6,29,64,90,100,101,4.18,0.0777645659928656,b,l,o,w,n,1,1,4,0.42267283937731637,0.07473002159827213,0.018682505399568033,6.110936947195648e-05
6/18/2022,364,cacao,47205,4101,0,1,9,27,36,23,4,1,10,37,73,96,100,4.83,0.0868763902129011,c,a,c,a,o,16,3,11,0.632152926386514,0.08552915766738661,0.021382289416846653,4.792252092125798e-06
6/19/2022,365,loser,55359,4399,1,10,28,32,19,8,2,11,39,71,90,98,100,3.9,0.0794631405914124,l,o,s,e,r,1,2,10,0.7637265602405744,0.03801295896328294,0.009503239740820735,3.653891046613265e-05
6/20/2022,366,input,50484,3950,0,5,30,38,21,6,1,5,35,73,94,100,101,4.0,0.0782426115204817,i,n,p,u,t,1,2,18,0.46275888387782316,0.01468682505399568,0.00367170626349892,0.0008262446691153484
6/21/2022,367,gloat,53342,4194,0,8,21,31,26,12,2,8,29,60,86,98,100,4.19,0.0786247234824341,g,l,o,a,t,1,2,6,0.58780646310611,0.04967602591792657,0.012419006479481642,1.6410856465296546e-06
6/22/2022,368,awful,47645,3861,0,5,21,33,27,12,2,5,26,59,86,98,100,4.26,0.0810368349249659,a,w,f,u,l,1,2,18,0.4383775982729489,0.06090712742980561,0.015226781857451403,7.537502878351343e-05
6/23/2022,369,brink,53111,4118,0,4,22,41,24,7,1,4,26,67,91,98,99,4.07,0.0775357270621905,b,r,i,n,k,1,1,4,0.4410192228067377,0.07473002159827213,0.018682505399568033,2.1451957090456423e-05
6/24/2022,370,smite,50617,3991,0,6,23,35,24,11,2,6,29,64,88,99,101,4.21,0.0788470276784479,s,m,i,t,e,1,2,5,0.6642451498128061,0.15809935205183584,0.03952483801295896,3.906351314524472e-06
6/25/2022,371,beady,46089,3670,0,3,19,39,29,10,1,3,22,61,90,100,101,4.3100000000000005,0.0796285447720714,b,e,a,d,y,1,2,12,0.5768422989705911,0.07473002159827213,0.018682505399568033,1.2709550563216354e-06
6/26/2022,372,rusty,50450,3954,0,9,37,34,13,5,1,9,46,80,93,98,99,3.67,0.0783746283448959,r,u,s,t,y,1,1,8,0.5666589153115476,0.04535637149028078,0.011339092872570195,4.017542184451718e-05
6/27/2022,373,retro,47986,3848,0,6,24,35,24,9,1,6,30,65,89,98,99,4.050000000000001,0.0801900554328345,r,e,t,r,o,4,2,9,0.7314816390366728,0.04535637149028078,0.011339092872570195,0.00011557810207024989
6/28/2022,374,droll,47312,3844,0,2,16,31,31,17,3,2,18,49,80,97,100,4.54,0.0812478863713222,d,r,o,l,l,4,1,4,0.5694930982606875,0.04794816414686825,0.011987041036717062,2.8328570274051482e-06
6/29/2022,375,gawky,45645,3957,0,1,5,22,33,28,10,1,6,28,61,89,99,5.08,0.0866907656917515,g,a,w,k,y,1,1,8,0.3733006687418464,0.04967602591792657,0.012419006479481642,4.4981990853695904e-07
6/30/2022,376,hutch,44212,3758,0,1,12,28,28,21,9,1,13,41,69,90,99,4.79,0.0849995476341264,h,u,t,c,h,4,1,8,0.3788321287116774,0.029805615550755938,0.0074514038876889845,1.9837193767711274e-05
7/1/2022,377,pinto,47248,3792,0,5,25,41,22,6,1,5,30,71,93,99,100,4.0200000000000005,0.0802573653911276,p,i,n,t,o,1,2,9,0.5183315927575565,0.061339092872570194,0.015334773218142549,1.6019806706680206e-05
7/2/2022,378,egret,41765,3515,0,3,14,33,33,15,2,3,17,50,83,98,100,4.489999999999999,0.0841613791452172,e,g,r,e,t,4,2,18,0.7186679640086896,0.031101511879049675,0.007775377969762419,5.7032616505929134e-06
7/3/2022,379,lilac,40486,3461,0,2,17,38,29,12,1,2,19,57,86,98,99,4.3100000000000005,0.0854863409573679,l,i,l,a,c,4,2,10,0.5886331923510866,0.03801295896328294,0.009503239740820735,2.511866257241374e-05
7/4/2022,380,sever,42645,3591,0,2,13,27,29,21,7,2,15,42,71,92,99,4.71,0.0842068237776996,s,e,v,e,r,4,2,10,0.7493416367546372,0.15809935205183584,0.03952483801295896,9.91502126632728e-06
7/5/2022,381,field,44578,3604,1,6,25,36,23,9,1,7,32,68,91,100,101,4.08,0.0808470546009242,f,i,e,l,d,1,2,12,0.5453095107181705,0.05874730021598272,0.01468682505399568,0.0019545140217383044
7/6/2022,382,fluff,47344,4049,0,0,4,25,44,23,4,0,4,29,73,96,100,4.98,0.0855229807367353,f,l,u,f,f,27,1,4,0.3000297069975605,0.05874730021598272,0.01468682505399568,1.1767537872563975e-05
7/7/2022,383,agape,43407,3671,0,2,18,36,27,15,3,2,20,56,83,98,101,4.48,0.0845716128734996,a,g,a,p,e,4,3,21,0.6802434117365947,0.06090712742980561,0.015226781857451403,5.987837465031538e-06
7/8/2022,384,voice,42806,3484,1,5,24,35,25,9,1,6,30,65,90,99,100,4.09,0.0813904592814091,v,o,i,c,e,1,3,13,0.5522973147979071,0.018574514038876888,0.004643628509719222,0.0009332799202337893
7/9/2022,385,stead,47094,3933,1,6,20,27,28,16,3,7,27,54,82,98,101,4.38,0.0835138234169958,s,t,e,a,d,1,2,6,0.7411022475619611,0.15809935205183584,0.03952483801295896,1.0470939498614735e-05
7/10/2022,386,berth,41785,3494,0,7,24,35,24,9,1,7,31,66,90,99,100,4.07,0.0836185233935622,b,e,r,t,h,1,1,8,0.5672478588688601,0.07473002159827213,0.018682505399568033,1.5256112590381364e-05
7/11/2022,387,madam,40545,3430,0,3,13,35,34,14,2,3,16,51,85,99,101,4.53,0.0845973609569614,m,a,d,a,m,16,2,10,0.5467600342183754,0.04622030237580994,0.011555075593952484,2.9234465615932585e-05
7/12/2022,388,night,46910,3870,1,8,27,27,17,13,7,9,36,63,80,93,100,4.180000000000001,0.0824984011937753,n,i,g,h,t,1,1,8,0.4325653384718995,0.015982721382289417,0.003995680345572354,0.0018857804533040062
7/13/2022,389,bland,46246,3727,0,7,31,38,18,4,0,7,38,76,94,98,98,3.73,0.0805907537949228,b,l,a,n,d,1,1,4,0.5069416161636223,0.07473002159827213,0.018682505399568033,2.3208863851025802e-05
7/14/2022,390,liver,40549,3388,0,4,16,26,25,20,8,4,20,46,71,91,99,4.609999999999999,0.0835532318922784,l,i,v,e,r,1,2,10,0.5984179372059169,0.03801295896328294,0.009503239740820735,0.00017537664293284125
7/15/2022,391,wedge,39234,3353,0,2,11,32,37,17,2,2,13,45,82,99,101,4.659999999999999,0.0854615894377325,w,e,d,g,e,4,2,9,0.5740007227121933,0.035853131749460046,0.008963282937365011,4.569351707142952e-05
7/16/2022,392,roomy,38769,3280,0,2,17,41,28,10,2,2,19,60,88,98,100,4.33,0.0846036781964972,r,o,o,m,y,4,2,12,0.5335024606870711,0.04535637149028078,0.011339092872570195,8.295259302512187e-06
7/17/2022,393,wacky,39611,3345,0,3,18,39,27,10,2,3,21,60,87,97,99,4.25,0.0844462396808967,w,a,c,k,y,1,1,8,0.39173312909856955,0.035853131749460046,0.008963282937365011,2.6898453285164594e-05
7/18/2022,394,flock,42574,3548,0,4,22,37,27,9,1,4,26,63,90,99,100,4.18,0.0833372480856861,f,l,o,c,k,1,1,4,0.39540694715709224,0.05874730021598272,0.01468682505399568,3.7346754429569493e-05
7/19/2022,395,angry,39667,3358,0,5,27,38,21,7,1,5,32,70,91,98,99,3.9699999999999993,0.0846547508004134,a,n,g,r,y,1,1,16,0.5312831059843448,0.06090712742980561,0.015226781857451403,0.0001338870841298115
7/20/2022,396,trite,42237,3685,0,4,14,22,22,23,15,4,18,40,62,85,100,4.91,0.0872457797665553,t,r,i,t,e,4,2,5,0.6854335148355627,0.06436285097192225,0.016090712742980563,4.153408427059497e-06
7/21/2022,397,aphid,39086,3367,0,6,24,36,23,9,2,6,30,66,89,98,100,4.109999999999999,0.0861433761449112,a,p,h,i,d,1,2,18,0.48920094905122236,0.06090712742980561,0.015226781857451403,4.263840832662545e-06
7/22/2022,398,tryst,43099,3665,0,3,26,41,23,6,1,3,29,70,93,99,100,4.0600000000000005,0.085036775795262,t,r,y,s,t,4,0,0,0.5990902824799446,0.06436285097192225,0.016090712742980563,2.9720532895696396e-06
7/23/2022,399,midge,36769,3111,0,2,18,39,28,10,2,2,20,59,87,97,99,4.279999999999999,0.0846093176317006,m,i,d,g,e,1,2,9,0.5072816840693843,0.04622030237580994,0.011555075593952484,4.4603047630387694e-06
7/24/2022,400,power,39813,3401,2,6,19,29,24,15,4,8,27,56,80,95,99,4.25,0.0854243588777535,p,o,w,e,r,1,2,10,0.5769112383367405,0.061339092872570194,0.015334773218142549,0.003273624021344011
7/25/2022,401,elope,39228,3339,0,4,22,32,26,13,2,4,26,58,84,97,99,4.24,0.0851177730192719,e,l,o,p,e,4,3,21,0.7256916645504805,0.031101511879049675,0.007775377969762419,1.083289312106094e-06
7/26/2022,402,cinch,39171,3507,0,2,15,24,22,25,13,2,17,41,63,88,101,4.96,0.0895305200275714,c,i,n,c,h,4,1,8,0.4101782277986401,0.08552915766738661,0.021382289416846653,6.172411564192258e-06
7/27/2022,403,motto,38384,3285,0,1,11,36,36,14,1,1,12,48,84,98,99,4.5,0.0855825343893288,m,o,t,t,o,16,2,9,0.5492829442557048,0.04622030237580994,0.011555075593952484,2.7364627129225186e-05
7/28/2022,404,stomp,40650,3490,0,7,26,32,21,11,2,7,33,65,86,97,99,4.05,0.0858548585485854,s,t,o,m,p,1,1,4,0.5369015102982434,0.15809935205183584,0.03952483801295896,1.687457432964069e-05
7/29/2022,405,upset,37791,3213,0,5,30,38,20,6,1,5,35,73,93,99,100,3.95,0.0850202429149797,u,p,s,e,t,1,2,18,0.6312841152683388,0.014254859611231102,0.0035637149028077755,8.010082495390008e-05
7/30/2022,406,bluff,37353,3171,0,2,14,42,31,10,1,2,16,58,89,99,100,4.359999999999999,0.0848927796964099,b,l,u,f,f,4,1,4,0.31308734501765334,0.07473002159827213,0.018682505399568033,5.643943961664923e-05
7/31/2022,407,cramp,39250,3369,1,8,26,33,19,10,2,9,35,68,87,97,99,3.96,0.0858343949044586,c,r,a,m,p,1,1,4,0.508929313842938,0.08552915766738661,0.021382289416846653,5.8094466559804594e-06
8/1/2022,408,quart,36662,3303,0,5,20,33,27,13,2,5,25,58,85,98,100,4.29,0.0900932845998581,q,u,a,r,t,1,2,12,0.511354473306769,0.009935205183585313,0.002483801295896328,2.8924607657354068e-05
8/2/2022,409,coyly,34909,3380,0,0,4,17,28,35,15,0,4,21,49,84,99,5.3500000000000005,0.0968231688103354,c,o,y,l,y,4,1,8,0.4518096279613011,0.08552915766738661,0.021382289416846653,7.537546219169869e-07
8/3/2022,410,youth,38381,3327,1,5,17,31,29,15,3,6,23,54,83,98,101,4.42,0.0866835152809984,y,o,u,t,h,1,2,12,0.45112042075387837,0.002591792656587473,0.0006479481641468683,0.0007429519951341962
8/4/2022,411,rhyme,37229,3336,0,4,22,39,25,8,1,4,26,65,90,98,99,4.1,0.0896075639958097,r,h,y,m,e,1,1,1,0.532691612464941,0.04535637149028078,0.011339092872570195,2.211440705467963e-05
8/5/2022,412,buggy,37350,3428,0,1,9,29,34,22,5,1,10,39,73,95,100,4.82,0.0917804551539491,b,u,g,g,y,4,1,8,0.2996753875154002,0.07473002159827213,0.018682505399568033,2.8250094498641255e-05
8/6/2022,413,alien,38841,3395,3,17,31,29,15,4,0,20,51,80,95,99,99,3.45,0.0874076362606524,a,l,i,e,n,1,3,22,0.70912329093057,0.06090712742980561,0.015226781857451403,0.00015155639904875483
8/7/2022,414,smear,36223,3190,0,2,16,39,29,12,2,2,18,57,86,98,100,4.39,0.0880655936835712,s,m,e,a,r,1,2,6,0.7546355380243692,0.15809935205183584,0.03952483801295896,1.862973301052954e-05
8/8/2022,415,unfit,35516,3187,0,3,24,38,25,9,1,3,27,65,90,99,100,4.16,0.0897342043022862,u,n,f,i,t,1,2,18,0.4365287359163843,0.014254859611231102,0.0035637149028077755,1.1761903566155656e-05
8/9/2022,416,patty,36223,3019,0,2,16,39,29,12,1,2,18,57,86,98,99,4.32,0.0833448361538249,p,a,t,t,y,4,1,8,0.5312669331203433,0.061339092872570194,0.015334773218142549,3.3801403239483664e-05
8/10/2022,417,cling,37654,3312,0,4,20,34,27,13,2,4,24,58,85,98,100,4.31,0.0879587825994582,c,l,i,n,g,1,1,4,0.4442960234007966,0.08552915766738661,0.021382289416846653,1.36708643650521e-05
8/11/2022,418,glean,37301,3243,0,6,23,37,24,8,1,6,29,66,90,98,99,4.04,0.0869413688641055,g,l,e,a,n,1,2,6,0.6450856807124005,0.04967602591792657,0.012419006479481642,3.3654434523863593e-06
8/12/2022,419,label,34198,3076,0,4,18,32,29,15,2,4,22,54,83,98,100,4.39,0.0899467805134803,l,a,b,e,l,4,2,10,0.6603393909964166,0.03801295896328294,0.009503239740820735,0.0005975233521596129
8/13/2022,420,hunky,35276,3185,0,1,11,33,25,22,7,1,12,45,70,92,99,4.73,0.0902880145141172,h,u,n,k,y,1,1,8,0.3424366993494983,0.029805615550755938,0.0074514038876889845,4.039349839639813e-06
8/14/2022,421,khaki,31652,2968,0,2,17,33,28,16,4,2,19,52,80,96,100,4.510000000000001,0.0937697459876153,k,h,a,k,i,4,2,5,0.43877071641531507,0.008639308855291577,0.0021598272138228943,2.1403198669615205e-05
8/15/2022,422,poker,35376,3180,0,4,17,30,27,17,5,4,21,51,78,95,100,4.51,0.0898914518317503,p,o,k,e,r,1,2,10,0.586671055092922,0.061339092872570194,0.015334773218142549,0.0018644472645032491
8/16/2022,423,gruel,35105,3087,0,3,19,39,29,9,1,3,22,61,90,99,100,4.25,0.0879361914257228,g,r,u,e,l,1,2,6,0.589714569217122,0.04967602591792657,0.012419006479481642,1.187480639841466e-06
8/17/2022,424,twice,35815,3173,1,6,28,38,21,6,1,7,35,73,94,100,101,3.97,0.0885941644562334,t,w,i,c,e,1,2,5,0.5384708861087866,0.06436285097192225,0.016090712742980563,0.00028815242880580696
8/18/2022,425,twang,34938,3172,0,3,22,43,25,7,1,3,25,68,93,100,101,4.180000000000001,0.0907893983628141,t,w,a,n,g,1,1,4,0.4686128931774226,0.06436285097192225,0.016090712742980563,3.5123110394298694e-06
8/19/2022,426,shrug,33965,2987,0,4,23,36,26,10,1,4,27,63,89,99,100,4.18,0.0879434712203739,s,h,r,u,g,1,1,2,0.4990795046239596,0.15809935205183584,0.03952483801295896,1.0409106597518315e-05
8/20/2022,427,treat,38245,3249,1,22,32,26,14,5,1,23,55,81,95,100,101,3.52,0.0849522813439665,t,r,e,a,t,4,2,6,0.7481315417258878,0.06436285097192225,0.016090712742980563,0.0002808819487103914
8/21/2022,428,waste,35617,3186,1,7,19,27,24,17,5,8,27,54,78,95,100,4.369999999999999,0.0894516663391077,w,a,s,t,e,1,2,9,0.7011757347861078,0.035853131749460046,0.008963282937365011,0.0005936183588574022
8/22/2022,429,merit,35888,3123,0,7,33,37,17,5,0,7,40,77,94,99,99,3.76,0.0870207311636201,m,e,r,i,t,1,2,10,0.6327502603770303,0.04622030237580994,0.011555075593952484,9.31956898407479e-05
8/23/2022,430,woven,33549,2933,0,2,13,32,32,17,3,2,15,47,79,96,99,4.54,0.0874243643625741,w,o,v,e,n,1,2,10,0.4930291105472001,0.035853131749460046,0.008963282937365011,6.13781692284518e-05
8/24/2022,431,needy,33700,2927,0,2,21,41,26,9,1,2,23,64,90,99,100,4.220000000000001,0.0868545994065281,n,e,e,d,y,4,2,12,0.6513791055109135,0.015982721382289417,0.003995680345572354,2.363717226663459e-05
8/25/2022,432,clown,36737,3175,1,8,29,36,20,6,1,9,38,74,94,100,101,3.91,0.0864251299779513,c,l,o,w,n,1,1,4,0.4434531212918187,0.08552915766738661,0.021382289416846653,4.4518258542412254e-05
8/26/2022,433,irony,34716,3046,0,6,29,34,21,8,1,6,35,69,90,98,99,3.95,0.0877405231017398,i,r,o,n,y,1,2,20,0.5509784521920614,0.01468682505399568,0.00367170626349892,3.1959418452148674e-05
8/27/2022,434,ruder,31241,2784,0,2,16,33,29,16,4,2,18,51,80,96,100,4.53,0.0891136647354438,r,u,d,e,r,4,2,10,0.6373847465572371,0.04535637149028078,0.011339092872570195,1.2953992779700337e-06
8/28/2022,435,gauze,30214,2866,0,2,11,24,31,25,8,2,13,37,68,93,101,4.94,0.0948566889521413,g,a,u,z,e,1,3,13,0.5284690033280025,0.04967602591792657,0.012419006479481642,8.035069921963927e-06
8/29/2022,436,chief,34281,3072,1,6,32,38,18,5,0,7,39,77,95,100,100,3.81,0.0896123216942329,c,h,i,e,f,1,2,6,0.49046386732901104,0.08552915766738661,0.021382289416846653,0.0006602192267406358
8/30/2022,437,onset,33660,3009,0,4,29,40,21,6,1,4,33,73,94,100,101,4.029999999999999,0.0893939393939394,o,n,s,e,t,1,2,18,0.7184326670775412,0.017710583153347732,0.004427645788336933,5.5748413606078195e-05
8/31/2022,438,prize,35343,3166,0,5,12,20,32,26,5,5,17,37,69,95,100,4.77,0.0895792660498542,p,r,i,z,e,1,2,5,0.5367193933108791,0.061339092872570194,0.015334773218142549,0.00023410888408418852
9/1/2022,439,fungi,31903,2928,0,2,18,41,28,9,1,2,20,61,89,98,99,4.23,0.0917782026768642,f,u,n,g,i,1,2,9,0.3772767045296787,0.05874730021598272,0.01468682505399568,2.890420857876805e-05
9/2/2022,440,charm,35724,3149,1,12,32,34,16,5,1,13,45,79,95,100,101,3.74,0.0881480237375434,c,h,a,r,m,1,1,4,0.5055564326553228,0.08552915766738661,0.021382289416846653,0.00015248230340185522
9/3/2022,441,gully,31191,2877,0,1,9,27,31,25,7,1,10,37,68,93,100,4.91,0.0922381456189285,g,u,l,l,y,4,1,8,0.4220273353828419,0.04967602591792657,0.012419006479481642,1.1568155660407033e-05
9/4/2022,442,inter,32018,2889,0,6,25,36,23,8,1,6,31,67,90,98,99,4.01,0.0902304953463676,i,n,t,e,r,1,2,18,0.668582014761893,0.01468682505399568,0.00367170626349892,0.00022059531799650508
9/5/2022,443,whoop,32733,2970,0,1,16,47,29,7,1,1,17,64,93,100,101,4.32,0.0907341215287324,w,h,o,o,p,4,2,6,0.4232879351447887,0.035853131749460046,0.008963282937365011,4.7928155227666295e-06
9/6/2022,444,taunt,32734,3022,0,4,19,27,21,16,13,4,23,50,71,87,100,4.65,0.0923199120180851,t,a,u,n,t,4,2,12,0.5738842537712869,0.06436285097192225,0.016090712742980563,4.263985302057631e-06
9/7/2022,445,leery,30992,2873,0,3,17,37,28,12,2,3,20,57,85,97,99,4.31,0.0927013422818791,l,e,e,r,y,4,2,12,0.7351971822736494,0.03801295896328294,0.009503239740820735,2.437198695085592e-06
9/8/2022,446,class,31962,3001,0,4,21,32,22,13,7,4,25,57,79,92,99,4.36,0.0938927476378199,c,l,a,s,s,4,1,4,0.7014720832655241,0.08552915766738661,0.021382289416846653,0.0027606334684529606
9/9/2022,447,theme,32172,2909,0,8,29,40,18,4,0,8,37,77,95,99,99,3.77,0.090420241203531,t,h,e,m,e,4,2,5,0.6457441554248711,0.06436285097192225,0.016090712742980563,0.0005377141783495433
9/10/2022,448,lofty,29237,2777,0,4,19,34,27,13,3,4,23,57,84,97,100,4.35,0.0949823853336525,l,o,f,t,y,1,1,8,0.4614445529165774,0.03801295896328294,0.009503239740820735,1.4716533846678034e-05
9/11/2022,449,tibia,27887,2675,0,1,14,40,30,12,2,1,15,55,85,97,99,4.4,0.0959228314268297,t,i,b,i,a,4,3,11,0.5711384257317969,0.06436285097192225,0.016090712742980563,8.968342214213655e-06
9/12/2022,450,booze,29147,2883,0,1,7,27,38,23,4,1,8,35,73,96,100,4.87,0.0989124095104127,b,o,o,z,e,4,3,13,0.5373516266395038,0.07473002159827213,0.018682505399568033,1.702852091704337e-05
9/13/2022,451,alpha,29497,2706,0,3,19,40,28,9,1,3,22,62,90,99,100,4.24,0.0917381428619859,a,l,p,h,a,4,2,17,0.5911731913093757,0.06090712742980561,0.015226781857451403,0.000402099298042272
9/14/2022,452,thyme,32142,2938,1,5,24,41,23,5,0,6,30,71,94,99,99,3.92,0.0914068819612967,t,h,y,m,e,1,1,1,0.5049992511437031,0.06436285097192225,0.016090712742980563,1.4559957916284804e-05
9/15/2022,453,doubt,33344,3011,1,12,32,34,16,4,0,13,45,79,95,99,99,3.61,0.090301103646833,d,o,u,b,t,1,2,12,0.44626945329031653,0.04794816414686825,0.011987041036717062,0.0002934355590085529
9/16/2022,454,parer,37309,4130,0,0,4,11,15,22,48,0,4,15,30,52,100,5.99,0.1106971508215176,p,a,r,e,r,4,2,10,0.7273965600439869,0.061339092872570194,0.015334773218142549,5.494748972666592e-07
9/17/2022,455,chute,33418,3073,0,11,37,36,12,3,0,11,48,84,96,99,99,3.55,0.091956430666108,c,h,u,t,e,1,2,5,0.5279044122937275,0.08552915766738661,0.021382289416846653,1.204881978479466e-05
9/18/2022,456,stick,33102,3038,1,9,36,35,14,4,0,10,46,81,95,99,99,3.61,0.0917769319074376,s,t,i,c,k,1,1,4,0.5101458942306855,0.15809935205183584,0.03952483801295896,0.0003235988183654876
9/19/2022,457,trice,35050,3430,0,5,24,25,18,17,11,5,29,54,72,89,100,4.51,0.0978601997146933,t,r,i,c,e,1,2,5,0.6446139438055802,0.06436285097192225,0.016090712742980563,5.121902357830973e-06
9/20/2022,458,alike,31277,2843,0,6,20,33,27,12,2,6,26,59,86,98,100,4.25,0.0908974645905937,a,l,i,k,e,1,3,21,0.6572839113848653,0.06090712742980561,0.015226781857451403,8.987064003122734e-05
9/21/2022,459,recap,31976,2900,0,5,30,35,21,8,1,5,35,70,91,99,100,4.0,0.0906930197648236,r,e,c,a,p,1,2,10,0.6588846276927667,0.04535637149028078,0.011339092872570195,4.1346880828443705e-05
9/22/2022,460,saint,34455,3119,1,14,35,29,15,5,1,15,50,79,94,99,100,3.62,0.0905238717167319,s,a,i,n,t,1,2,12,0.6702884505281616,0.15809935205183584,0.03952483801295896,0.0005624069451452461
9/23/2022,461,glory,31509,2893,0,6,30,39,19,5,0,6,36,75,94,99,99,3.83,0.0918150369735631,g,l,o,r,y,1,1,4,0.5045423738156873,0.04967602591792657,0.012419006479481642,0.0001901047632250051
9/24/2022,462,grate,32777,3077,1,14,29,28,16,8,3,15,44,72,88,96,99,3.77,0.0938768038563627,g,r,a,t,e,1,2,5,0.6888795103391823,0.04967602591792657,0.012419006479481642,9.71058262534236e-06
9/25/2022,463,admit,28994,2677,0,10,25,34,22,8,1,10,35,69,91,99,100,3.96,0.0923294474718907,a,d,m,i,t,1,2,18,0.5367452617865827,0.06090712742980561,0.015226781857451403,0.00012685360607703303
9/26/2022,464,brisk,31706,2884,0,5,23,38,24,7,1,5,28,66,90,97,98,4.0,0.0909607014445215,b,r,i,s,k,1,1,4,0.517057973637421,0.07473002159827213,0.018682505399568033,1.1181931179586533e-05
9/27/2022,465,soggy,30985,2888,0,2,18,38,28,11,2,2,20,58,86,97,99,4.3,0.093206390188801,s,o,g,g,y,4,1,8,0.4760352000966318,0.15809935205183584,0.03952483801295896,4.789521620558689e-06
9/28/2022,466,usurp,31355,3007,0,3,21,38,26,9,1,3,24,62,88,97,98,4.12,0.0959017700526231,u,s,u,r,p,4,2,20,0.5292730500298833,0.014254859611231102,0.0035637149028077755,2.477014460371045e-06
9/29/2022,467,scald,30477,2829,0,4,23,36,24,11,2,4,27,63,87,98,100,4.21,0.0928240968599271,s,c,a,l,d,1,1,4,0.603760648908808,0.15809935205183584,0.03952483801295896,1.4712618726071227e-06
9/30/2022,468,scorn,31223,2859,0,8,31,35,20,6,1,8,39,74,94,100,101,3.92,0.0915671139864843,s,c,o,r,n,1,1,4,0.6080333979775003,0.15809935205183584,0.03952483801295896,8.999345346398916e-06
10/1/2022,469,leave,28202,2696,0,4,16,34,31,12,1,4,20,54,85,97,98,4.26,0.0955960570172328,l,e,a,v,e,4,3,13,0.7306956621663004,0.03801295896328294,0.009503239740820735,0.0010251223219099566
10/2/2022,470,twine,30088,2775,0,6,28,40,20,5,1,6,34,74,94,99,100,3.93,0.0922294602499335,t,w,i,n,e,1,2,5,0.5624389570650994,0.06436285097192225,0.016090712742980563,6.002082147386928e-06
10/3/2022,471,sting,32288,2969,1,10,30,33,18,8,2,11,41,74,92,100,102,3.95,0.0919536669970267,s,t,i,n,g,1,1,4,0.543552813419667,0.15809935205183584,0.03952483801295896,4.006516280218823e-05
10/4/2022,472,bough,32014,3060,0,3,17,35,28,13,3,3,20,55,83,96,99,4.36,0.0955831823577185,b,o,u,g,h,1,2,12,0.37374138131255963,0.07473002159827213,0.018682505399568033,7.513376489372132e-06
10/5/2022,473,marxh,30935,2885,0,9,30,35,19,6,1,9,39,74,93,99,100,3.86,0.0932600614191045,m,a,r,x,h,1,1,8,0.4431463638112104,0.04622030237580994,0.011555075593952484,0.0
10/6/2022,474,sloth,32522,2987,1,10,38,34,13,3,0,11,49,83,96,99,99,3.54,0.0918455199557222,s,l,o,t,h,1,1,4,0.5869619153372863,0.15809935205183584,0.03952483801295896,7.504144895026194e-06
10/7/2022,475,dandy,29026,2840,0,2,11,23,29,24,11,2,13,36,65,89,100,4.949999999999999,0.09784331289189,d,a,n,d,y,4,1,8,0.48579440885040726,0.04794816414686825,0.011987041036717062,1.5865455604971286e-05
10/8/2022,476,vigor,26905,2642,0,2,15,35,31,14,2,2,17,52,83,97,99,4.42,0.0981973610853001,v,i,g,o,r,1,2,10,0.46428515637112544,0.018574514038876888,0.004643628509719222,1.4122519034906639e-05
10/9/2022,477,howdy,28408,2668,0,2,13,32,32,17,4,2,15,47,79,96,100,4.61,0.0939172064207265,h,o,w,d,y,1,1,8,0.366576907947017,0.029805615550755938,0.0074514038876889845,1.049775301834253e-05
10/10/2022,478,enjoy,26878,2654,0,3,12,29,33,20,3,3,15,44,77,97,100,4.64,0.0987424659572884,e,n,j,o,y,1,2,18,0.5119229717698403,0.031101511879049675,0.007775377969762419,0.0007243905672536629
10/11/2022,479,valid,28575,2752,0,4,28,38,21,8,1,4,32,70,91,99,100,4.04,0.0963079615048119,v,a,l,i,d,1,2,10,0.502412938615469,0.018574514038876888,0.004643628509719222,0.0008248438360728453
10/12/2022,480,ionic,29151,2947,0,2,13,25,28,21,11,2,15,40,68,89,100,4.859999999999999,0.1010943020822613,i,o,n,i,c,4,3,26,0.5307249435621766,0.01468682505399568,0.00367170626349892,2.6121395749820382e-05
10/13/2022,481,equal,27197,2677,0,5,23,35,25,11,2,5,28,63,88,99,101,4.239999999999999,0.0984299738941795,e,q,u,a,l,1,3,22,0.5816842031449532,0.031101511879049675,0.007775377969762419,0.0005032209111769971
10/14/2022,482,floor,28906,2752,0,3,23,44,24,6,0,3,26,70,94,100,100,4.07,0.0952051477201965,f,l,o,o,r,4,2,6,0.555751100839023,0.05874730021598272,0.01468682505399568,0.0007766653153834965
10/15/2022,483,catch,30403,3123,0,7,18,20,15,16,23,7,25,45,60,76,99,4.8,0.1027201263033253,c,a,t,c,h,4,1,8,0.48972775476263486,0.08552915766738661,0.021382289416846653,0.0002947317095273774
10/16/2022,484,spade,30459,2854,1,8,29,36,19,6,1,9,38,74,93,99,100,3.86,0.0936997275025444,s,p,a,d,e,1,2,5,0.6926749045588223,0.15809935205183584,0.03952483801295896,2.264651673065706e-05
10/17/2022,485,stein,31269,2965,1,12,34,32,16,5,1,13,47,79,95,100,101,3.7199999999999993,0.0948223480124084,s,t,e,i,n,1,2,6,0.7000769041976689,0.15809935205183584,0.03952483801295896,5.624979464172102e-05
10/18/2022,486,exist,28612,2805,0,5,24,38,23,8,1,5,29,67,90,98,99,4.04,0.0980357891793653,e,x,i,s,t,1,2,20,0.6136987643972436,0.031101511879049675,0.007775377969762419,0.0003662173188094703
10/19/2022,487,quirk,28322,2794,0,3,23,39,24,9,2,3,26,65,89,98,100,4.19,0.0986512251959607,q,u,i,r,k,1,2,12,0.3799655667970697,0.009935205183585313,0.002483801295896328,6.4154379806044086e-06
10/20/2022,488,denim,28741,2769,0,5,29,40,20,5,0,5,34,74,94,99,99,3.87,0.0963432030896628,d,e,n,i,m,1,2,10,0.5496822153824203,0.04794816414686825,0.011987041036717062,6.844315605629832e-05
10/21/2022,489,grove,28637,2794,0,4,18,30,28,17,3,4,22,52,80,97,100,4.45,0.0975660858330132,g,r,o,v,e,1,2,5,0.5567716369309579,0.04967602591792657,0.012419006479481642,0.00021944168653593204
10/22/2022,490,spiel,29084,2810,0,7,32,36,19,6,1,7,39,75,94,100,101,3.92,0.0966166964654105,s,p,i,e,l,1,2,6,0.6692510930363256,0.15809935205183584,0.03952483801295896,1.172978801962824e-05
10/23/2022,491,mummy,29279,3021,0,1,4,14,27,37,18,1,5,19,46,83,101,5.529999999999999,0.1031797534068786,m,u,m,m,y,27,1,8,0.32172953985769903,0.04622030237580994,0.011555075593952484,2.714483139154272e-05
10/24/2022,492,fault,28947,2768,0,7,27,35,22,8,1,7,34,69,91,99,100,4.0,0.0956230352022662,f,a,u,l,t,1,2,12,0.5168282946485047,0.05874730021598272,0.01468682505399568,0.00018943786360341326
10/25/2022,493,foggy,28953,2817,0,2,13,35,32,15,3,2,15,50,82,97,100,4.54,0.0972956170345041,f,o,g,g,y,4,1,8,0.3421904583750406,0.05874730021598272,0.01468682505399568,1.0176221932641137e-05
10/26/2022,494,flout,30063,2904,0,6,28,37,21,7,1,6,34,71,92,99,100,3.98,0.0965971459934138,f,l,o,u,t,1,2,6,0.4724860306380519,0.05874730021598272,0.01468682505399568,1.0459006326580707e-06
10/27/2022,495,carry,27609,2615,0,4,22,35,24,12,3,4,26,61,85,97,100,4.2700000000000005,0.0947154913252924,c,a,r,r,y,4,1,8,0.5942594277359754,0.08552915766738661,0.021382289416846653,0.0004775649235834433
10/28/2022,496,sneak,27905,2636,0,7,28,36,21,7,1,7,35,71,92,99,100,3.96,0.094463357821179,s,n,e,a,k,1,2,6,0.6940840514686197,0.15809935205183584,0.03952483801295896,3.295169204535116e-05
10/29/2022,497,libel,25156,2536,0,3,15,32,32,16,2,3,18,50,82,98,100,4.489999999999999,0.100810939736047,l,i,b,e,l,4,2,10,0.5976413641060916,0.03801295896328294,0.009503239740820735,1.2523040574161493e-05
10/30/2022,498,waltz,24672,2496,0,2,11,29,35,19,3,2,13,42,77,96,99,4.63,0.1011673151750972,w,a,l,t,z,1,1,8,0.4451796778843786,0.035853131749460046,0.008963282937365011,2.489238015889195e-05
10/31/2022,499,aptly,26498,2572,0,3,26,41,23,7,1,3,29,70,93,100,101,4.120000000000001,0.0970639293531587,a,p,t,l,y,1,1,16,0.5320169648884691,0.06090712742980561,0.015226781857451403,8.644629640646478e-06
11/2/2022,501,inept,27670,2640,0,6,30,39,20,6,1,6,36,75,95,101,102,4.01,0.0954101915431875,i,n,e,p,t,1,2,20,0.5924623104375165,0.01468682505399568,0.00367170626349892,6.624398513655494e-06
11/3/2022,502,aloud,29554,2819,1,18,31,30,15,4,1,19,50,80,95,99,100,3.56,0.0953847194965148,a,l,o,u,d,1,3,22,0.576102943724716,0.06090712742980561,0.015226781857451403,5.408729005445023e-05
11/4/2022,503,photo,27330,2565,0,5,34,43,15,3,0,5,39,82,97,100,100,3.77,0.0938529088913282,p,h,o,t,o,4,2,5,0.5017386315203445,0.061339092872570194,0.015334773218142549,0.0032812647331582107
11/5/2022,504,dream,29743,2751,5,14,31,29,15,4,1,19,50,79,94,98,99,3.48,0.092492351141445,d,r,e,a,m,1,2,6,0.656924103667653,0.04794816414686825,0.011987041036717062,0.0004842407965425676
11/6/2022,505,stale,31068,3013,2,19,30,27,15,6,2,21,51,78,93,99,101,3.63,0.0969808162739796,s,t,a,l,e,1,2,5,0.7803764629297893,0.15809935205183584,0.03952483801295896,1.5395482215819956e-05
11/7/2022,506,begin,26096,2439,0,6,26,36,23,7,1,6,32,68,91,98,99,3.98,0.0934625996321275,b,e,g,i,n,1,2,10,0.520037769109465,0.07473002159827213,0.018682505399568033,0.0006563952807690679
11/8/2022,507,spell,27213,2531,0,4,24,37,24,9,1,4,28,65,89,98,99,4.09,0.0930070187042957,s,p,e,l,l,4,1,4,0.6652155459729873,0.15809935205183584,0.03952483801295896,0.0001228863753594197
11/9/2022,508,rainy,28984,2678,1,16,38,31,11,3,1,17,55,86,97,100,101,3.51,0.0923958045818382,r,a,i,n,y,1,2,12,0.5953207162025143,0.04535637149028078,0.011339092872570195,3.5670764977187283e-05
11/10/2022,509,unite,27467,2575,1,11,31,33,18,5,1,12,43,76,94,99,100,3.75,0.0937488622710889,u,n,i,t,e,1,3,21,0.6084582862722582,0.014254859611231102,0.0035637149028077755,4.173322088478027e-05
11/11/2022,510,medal,25993,2438,0,5,25,38,23,8,1,5,30,68,91,99,100,4.07,0.0937944831300734,m,e,d,a,l,1,2,10,0.6299817741145408,0.04622030237580994,0.011555075593952484,0.00011192096046224721
11/12/2022,511,valet,24660,2356,0,4,22,38,25,9,1,4,26,64,89,98,99,4.12,0.0955393349553933,v,a,l,e,t,1,2,10,0.6334236027750041,0.018574514038876888,0.004643628509719222,2.9655088259722843e-05
11/13/2022,512,inane,25085,2515,0,8,25,30,21,13,3,8,33,63,84,97,100,4.15,0.1002591189954155,i,n,a,n,e,4,3,21,0.6915217590887747,0.01468682505399568,0.00367170626349892,4.613529003466024e-06
11/14/2022,513,maple,26536,2467,1,6,26,36,21,8,1,7,33,69,90,98,99,3.95,0.0929680434127223,m,a,p,l,e,1,2,9,0.6200786147111046,0.04622030237580994,0.011555075593952484,0.00014020106125424764
11/15/2022,514,snarl,27475,2650,0,5,21,31,24,15,4,5,26,57,81,96,100,4.3500000000000005,0.0964513193812556,s,n,a,r,l,1,1,4,0.6939452647860611,0.15809935205183584,0.03952483801295896,2.667468463911729e-06
11/16/2022,515,baker,25576,2541,0,5,16,23,24,22,10,5,21,44,68,90,100,4.72,0.0993509540193931,b,a,k,e,r,1,2,10,0.6178408091620288,0.07473002159827213,0.018682505399568033,0.00021471720503704066
11/17/2022,516,there,27465,2530,0,14,35,33,14,4,0,14,49,82,96,100,100,3.5900000000000007,0.0921172401237939,t,h,e,r,e,4,2,5,0.7261197712046412,0.06436285097192225,0.016090712742980563,0.010129763536804368
11/18/2022,517,glyph,29208,2899,0,2,23,49,20,5,1,2,25,74,94,99,100,4.06,0.0992536291427006,g,l,y,p,h,1,0,0,0.3534811035892206,0.04967602591792657,0.012419006479481642,9.134178632831838e-06
11/19/2022,518,avert,24749,2400,0,7,26,35,22,9,1,7,33,68,90,99,100,4.03,0.0969736150955594,a,v,e,r,t,1,2,20,0.6603659323281161,0.06090712742980561,0.015226781857451403,1.1087087021713167e-05
11/20/2022,519,brave,24991,2396,1,6,17,27,27,18,5,7,24,51,78,96,101,4.5,0.0958745148253371,b,r,a,v,e,1,2,5,0.5987660793836316,0.07473002159827213,0.018682505399568033,7.543261428439435e-05
11/21/2022,520,axiom,24288,2382,0,5,19,33,27,13,3,5,24,57,84,97,100,4.33,0.0980731225296442,a,x,i,o,m,1,3,22,0.49518114722352663,0.06090712742980561,0.015226781857451403,2.1605007967609578e-05
11/22/2022,521,prime,27437,2534,1,10,26,32,21,9,1,11,37,69,90,99,100,3.93,0.0923570361191092,p,r,i,m,e,1,2,5,0.5843229173738917,0.061339092872570194,0.015334773218142549,0.0005534391663616733
11/23/2022,522,drive,26663,2451,1,12,32,30,18,6,1,13,45,75,93,99,100,3.74,0.0919251397067096,d,r,i,v,e,1,2,5,0.5591437218380886,0.04794816414686825,0.011987041036717062,0.0015573709918923985
11/24/2022,523,feast,27705,2725,5,13,25,27,19,10,2,18,43,70,89,99,101,3.830000000000001,0.0983576971665764,f,e,a,s,t,1,2,12,0.704968940197086,0.05874730021598272,0.01468682505399568,6.0186181143483686e-05
11/25/2022,524,itchy,24197,2329,0,8,28,40,18,5,1,8,36,76,94,99,100,3.87,0.0962516014381948,i,t,c,h,y,1,1,16,0.42437645401242063,0.01468682505399568,0.00367170626349892,1.7075805750054726e-05
11/26/2022,525,clean,26381,2424,1,17,36,31,12,3,0,18,54,85,97,100,100,3.45,0.0918843106781395,c,l,e,a,n,1,2,6,0.6635181410691235,0.08552915766738661,0.021382289416846653,0.0006556274259341906
11/27/2022,526,happy,25206,2356,0,6,28,39,19,6,1,6,34,73,92,98,99,3.9,0.0934698087756883,h,a,p,p,y,4,1,8,0.43103936592645076,0.029805615550755938,0.0074514038876889845,0.0009169750176228482
11/28/2022,527,tepid,26051,2484,0,10,38,35,13,3,0,10,48,83,96,99,99,3.5700000000000003,0.095351426048904,t,e,p,i,d,1,2,10,0.5707896269114836,0.06436285097192225,0.016090712742980563,3.1883673148305557e-06
11/29/2022,528,undue,23739,2316,0,3,19,35,29,13,2,3,22,57,86,99,101,4.4,0.0975609756097561,u,n,d,u,e,4,3,19,0.5327171566726947,0.014254859611231102,0.0035637149028077755,1.9901627117919227e-05
12/1/2022,530,eject,22628,2200,0,2,11,35,36,14,2,2,13,48,84,98,100,4.55,0.0972246773908432,e,j,e,c,t,4,2,20,0.6055584633833591,0.031101511879049675,0.007775377969762419,1.3508032909851686e-05
12/2/2022,531,chafe,24646,2343,0,6,30,33,19,9,2,6,36,69,88,97,99,3.97,0.0950661364927371,c,h,a,f,e,1,2,5,0.553161894219336,0.08552915766738661,0.021382289416846653,1.7167587156752287e-06
12/3/2022,532,torso,23873,2260,0,4,35,36,17,6,1,4,39,75,92,98,99,3.85,0.094667616135383,t,o,r,s,o,4,2,9,0.6888458107924886,0.06436285097192225,0.016090712742980563,2.55647551705575e-05
12/4/2022,533,adore,25577,2398,2,17,32,29,15,5,1,19,51,80,95,100,101,3.6,0.0937561090041834,a,d,o,r,e,1,3,21,0.7327486998375214,0.06090712742980561,0.015226781857451403,1.6993068127489488e-05
12/5/2022,534,woken,23153,2200,0,2,10,25,36,23,4,2,12,37,73,96,100,4.8,0.0950200837904375,w,o,k,e,n,1,2,10,0.5121038403255974,0.035853131749460046,0.008963282937365011,5.26307785070813e-06
12/6/2022,535,amber,23509,2261,0,6,22,33,24,12,3,6,28,61,85,97,100,4.23,0.0961759326215491,a,m,b,e,r,1,2,18,0.6338484343228707,0.06090712742980561,0.015226781857451403,0.00015986271025999102
12/7/2022,536,joust,24899,2388,0,6,29,34,21,8,2,6,35,69,90,98,100,4.0200000000000005,0.0959074661632997,j,o,u,s,t,1,2,12,0.5017311409307017,0.008639308855291577,0.0021598272138228943,2.315974425669687e-06
12/8/2022,537,infer,21199,1863,0,3,19,33,26,14,3,3,22,55,81,95,98,4.3,0.0878815038445209,i,n,f,e,r,1,2,18,0.5939245237973155,0.01468682505399568,0.00367170626349892,1.595722256472934e-05
12/9/2022,538,braid,23640,2165,0,10,36,35,14,3,0,10,46,81,95,98,98,3.5600000000000005,0.0915820642978003,b,r,a,i,d,1,2,6,0.555521024621868,0.07473002159827213,0.018682505399568033,1.418610001568359e-05
12/10/2022,539,knock,21157,2041,0,3,18,43,27,8,1,3,21,64,91,99,100,4.220000000000001,0.0964692536749066,k,n,o,c,k,4,1,4,0.38377202666050014,0.008639308855291577,0.0021598272138228943,7.506648549643018e-05
12/11/2022,540,naive,21947,2075,1,7,24,32,24,11,1,8,32,64,88,99,100,4.08,0.0945459516106985,n,a,i,v,e,1,3,13,0.6206076497646726,0.015982721382289417,0.003995680345572354,2.670500876514565e-05
12/12/2022,541,apply,22873,2150,0,5,28,38,22,7,1,5,33,71,93,100,101,4.05,0.0939972893804922,a,p,p,l,y,4,1,16,0.48358962188533033,0.06090712742980561,0.015226781857451403,0.0011029007146562265
12/13/2022,542,spoke,24101,2224,0,6,31,38,19,5,0,6,37,75,94,99,99,3.82,0.0922783287000539,s,p,o,k,e,1,2,5,0.6181659445286978,0.15809935205183584,0.03952483801295896,0.0001672654665335465
12/14/2022,543,usual,20824,2048,0,3,20,39,27,10,1,3,23,62,89,99,100,4.24,0.098348059930849,u,s,u,a,l,4,3,22,0.618241669201699,0.014254859611231102,0.0035637149028077755,0.00024624780943069776
12/15/2022,544,rival,22176,2127,0,7,27,35,22,8,1,7,34,69,91,99,100,4.0,0.0959145021645021,r,i,v,a,l,1,2,10,0.5686294835364095,0.04535637149028078,0.011339092872570195,6.20961243342667e-05
12/16/2022,545,probe,22853,2160,0,6,24,32,24,11,3,6,30,62,86,97,100,4.19,0.0945171312300354,p,r,o,b,e,1,2,5,0.5937620817678115,0.061339092872570194,0.015334773218142549,0.00013932340967910567
12/17/2022,546,chord,22336,2088,0,7,39,38,13,3,0,7,46,84,97,100,100,3.66,0.0934813753581661,c,h,o,r,d,1,1,4,0.4753732395036998,0.08552915766738661,0.021382289416846653,4.5124249867036204e-05
12/18/2022,547,taper,22166,2108,0,8,28,30,20,11,3,8,36,66,86,97,100,4.07,0.0951006045294595,t,a,p,e,r,1,2,10,0.699704198722749,0.06436285097192225,0.016090712742980563,1.869533656283768e-05
12/19/2022,548,slate,26010,2422,6,14,33,27,13,5,1,20,53,80,93,98,99,3.43,0.093118031526336,s,l,a,t,e,1,2,5,0.7803764629297893,0.15809935205183584,0.03952483801295896,5.5099240379263304e-05
12/20/2022,549,third,24137,2261,1,10,47,32,9,2,0,11,58,90,99,101,101,3.47,0.0936736131250776,t,h,i,r,d,1,1,4,0.4978370476538099,0.06436285097192225,0.016090712742980563,0.001379527273993568
12/21/2022,550,lunar,22180,2036,0,5,32,40,17,4,0,5,37,77,94,98,98,3.75,0.0917944093778178,l,u,n,a,r,1,2,10,0.6023266468606505,0.03801295896328294,0.009503239740820735,5.217864708822298e-05
12/22/2022,551,excel,20490,2034,0,1,13,34,34,15,2,1,14,48,82,97,99,4.51,0.0992679355783309,e,x,c,e,l,4,2,18,0.6069284549382057,0.031101511879049675,0.007775377969762419,0.00020418535724145805
12/23/2022,552,aorta,21937,2112,0,7,26,35,20,10,3,7,33,68,88,98,101,4.130000000000001,0.0962756985914208,a,o,r,t,a,4,3,25,0.7414844297677168,0.06090712742980561,0.015226781857451403,9.261311700506724e-06
12/24/2022,553,poise,20281,1911,2,11,34,32,15,6,1,13,47,79,94,100,101,3.72,0.09422612297224,p,o,i,s,e,1,3,13,0.691642402979536,0.061339092872570194,0.015334773218142549,4.901312038475538e-06
12/25/2022,554,extra,15554,1562,1,5,20,35,28,10,1,6,26,61,89,99,100,4.180000000000001,0.1004243281471004,e,x,t,r,a,1,2,17,0.644901901851793,0.031101511879049675,0.007775377969762419,0.0008578203624072116
12/26/2022,555,judge,20011,2043,0,2,8,16,26,33,14,2,10,26,52,85,99,5.18,0.1020938483833891,j,u,d,g,e,1,2,9,0.41889839286724007,0.008639308855291577,0.0021598272138228943,0.00044649468536416437
12/27/2022,556,condo,20879,2012,0,2,17,35,29,14,3,2,19,54,83,97,100,4.45,0.0963647684276066,c,o,n,d,o,4,2,9,0.5057709440108824,0.08552915766738661,0.021382289416846653,9.310832919753995e-05
12/28/2022,557,impel,20160,1937,0,3,21,40,25,9,1,3,24,64,89,98,99,4.15,0.0960813492063492,i,m,p,e,l,1,2,18,0.5573805878207796,0.01468682505399568,0.00367170626349892,1.2488945796921408e-06
12/29/2022,558,havoc,20001,1919,0,2,16,38,30,12,2,2,18,56,86,98,100,4.4,0.095945202739863,h,a,v,o,c,1,2,10,0.46592305810618195,0.029805615550755938,0.0074514038876889845,2.4446981013844594e-05
12/30/2022,559,molar,21204,1973,0,4,21,38,26,9,1,4,25,63,89,98,99,4.140000000000001,0.0930484814186002,m,o,l,a,r,1,2,10,0.6220676013555211,0.04622030237580994,0.011555075593952484,9.394295778682556e-06
12/31/2022,560,manly,20380,1899,0,2,17,37,29,12,2,2,19,56,85,97,99,4.34,0.093179587831207,m,a,n,l,y,1,1,8,0.5109095533594058,0.04622030237580994,0.011555075593952484,1.8210092758625857e-05
